__________
|*    |  |
|  ‾     |
| |     ‾|
|    ‾  _|
|   ‾ | o|
‾‾‾‾‾‾‾‾‾‾
