__________
|*_ |    |
|       _|
|  | _   |
|   _   _|
|     | o|
‾‾‾‾‾‾‾‾‾‾

