__________
|* _  |  |
|        |
| |     ‾|
|   _‾  _|
|     | o|
‾‾‾‾‾‾‾‾‾‾

